Wifi	KEYWORD1
API	KEYWORD1
connect	KEYWORD2
getIP	KEYWORD2
getRSSI	KEYWORD2
Json	KEYWORD1
get	KEYWORD2
toArray	KEYWORD2
size	KEYWORD2
postEvent	KEYWORD2
login	KEYWORD2
createWeatherStation	KEYWORD2
postWeatherData	KEYWORD2
getWeatherData	KEYWORD2
getWeatherStation	KEYWORD2
getEvents	KEYWORD2
Timer	KEYWORD1
start	KEYWORD2
stop	KEYWORD2
restart	KEYWORD2
reset	KEYWORD2
set	KEYWORD2
waitFor	KEYWORD2
done	KEYWORD2
getElapsedTime	KEYWORD2
